NO ./resources/wall2.xpm
SO ./resources/wall32.xpm
WE ./resources/wall1.xpm
EA ./resources/wall8.xpm

C      200 ,     230,           255
F 80,60,30

        1111111111111111111111111
        1000000000100000000000001
        1011000000100000010000001
        1011000000100000010000001
        1011000000100000010000001
        1011000000100000010000001
        1011000000100000010000001
        1S11000000100000010000001
        1001000000000011110000001
111111111011000001110000000000001
100000000011000001110011111111111
1111011111111101110000001
11111111111111011101001011111
11000000110101011100000010001
10000000000000001100000010001
10000000000000001101010010001
11000001110101011111011110011
11110111 1110101 101111010001
11111111 1111111 111111111111
